#############
# W a l l x #
# # # # # # #
# M a r i a #
#############